# use these?
Schmoov - Spirits (Lights Out Mix).alc
Einmusik - Dune Suave (Original Mix).alc
Djuma Soundsystem - Les Djinns (Trentemoller Remix Fixed).alc

Matthew Dekay & Lee Burridge - Lost In A Moment.alc

Ascension - Someone
David Hohme - Without Doubt (Rodriguez Jr. Remix)
Arty - Kate (2015 Remix)
Capital Cities - Safe And Sound (Cash Cash Remix)
U2 - Even Better than the Real Thing (Perfecto Mix)
Elastic Reality - Cassa De X (Osamu M Remix)
Silicone Soul - Devil Drives (Darkroom Dub)
Deadmau5 - SATRN (Original Mix)
Steve Brian - Avocado (Cabriolet Paris Remix)
Bicep - Opal (Four Tet Remix)
Nick Warren, Tripswitch - Voight Kampff (Original Mix)
Brother Brown - Under The Water (Frankeepella)
Booka Shade - Night Falls
Tim Engelhardt - Reality
MEZERG - Welcome Theremin (Original Mix)
PTFA - Gornal (Original Upper Mix)
Andhim - Boy Boy Boy (Joris Voorn Remix)
Guy Gerber, Dixon - No Distance (Original Mix)
DAVI - Lie Machine (Gorgon City Remix)
Max Manie - Sunday (Klangkarussell Remix)
Purity Ring - Repetition
Dusky - Skin Deep (Global Communication Remix)
Oovation - Falter (Juan Deminicis Remix)
N'to - Starlings (Henry Saiz Remix)
Laid Back - Bakerman (Soul Clap Remix)
Flight Facilities - Down To Earth (YOUNGr Live Mix)
Flight Facilities - Down To Earth (Original Mix)
Dickystixxx - Make Me Feel Better (Club Edit)
Rufus - You Were Right (Nora En Pure Remix)
Sebastien Leger - Lanarka (Original Mix)
Gorgon City, Sofi Tukker - House Arrest (Extended Mix)
Elderbrook - Numb (Joris Voorn Remix)
Einmusik - Dune Suave (Original Mix)
Jesper Ryom - Ghostly (Original Mix)
Rodriguez Jr. - Heal Me (Original Mix)
Bicep - Nova
Sorcha Richardson - Last Train (Lexer Remix)
Eelke Kleijn - Moments Of Clarity (Extended Mix)
Ben Bohmer, Malou - Lost In Mind (Volen Sentir Extended Vision)
Paulo Rocha - Dreamwalker (Dancing In Our Sleep Mix)
Eli & Fur - Over Again (Original Mix)
Nicolas Jaar - El Bandido (Original Mix)
Fatboy Slim - Praise You (Maribou State Remix)
Francesco Rossi - Paper Aeroplane
Fatboy Slim - Praise You (Maribou State Remix)
Teddy Pendergrass - Life Is A Song Worth Singing (Jamie Jones Remix)
Super8 & Tab - Helsinki Scorchin' (Michael Cassette Remix)
Jayda G - Both Of Us (Original Mix)